Beloved - Toni Morrison 
Days Without End - Sebastian Barry 
Fugitive Pieces - Anne Michaels 
Half of a Yellow Sun - Chimamanda Ngozi Adichie 
Homegoing - Yaa Gyasi 
The God of Small Things - Arundhati Roy 
Things Fall Apart - Chinua Achebe 
White Teeth - Zadie Smith 
Bridget Jones’s Diary - Helen Fielding 
Pride and Prejudice - Jane Austen 
The Forty Rules of Love - Elif Shafak 
The Slaves of Solitude - Patrick Hamilton 
Eye of the Needle - Ken Follett 
His Dark Materials: The Golden Compass (HBO Tie-In Edition) - Philip Pullman 
Ivanhoe - Sir Walter Scott 
The Big Sleep (Special Edition) - Raymond Chandler 
The Fellowship of the Ring (Media Tie-in) - J.R.R. Tolkien 
A Game of Thrones (HBO Tie-in Edition) - George R. R. Martin 
Dune - Frank Herbert 
Frankenstein: The 1818 Text - Mary Shelley 
The Science of Discworld - Terry Pratchett 
The Road - Cormac McCarthy 
A Thousand Splendid Suns - Khaled Hosseini 
Home Fire - Kamila Shamsie 
Lord of the Flies - William Golding 
The Color Purple (Movie Tie-In) - Alice Walker 
A House for Mr. Biswas - V. S. Naipaul 
Cannery Row - John Steinbeck 
Disgrace - J. M. Coetzee 
Our Mutual Friend - Charles Dickens 
Saturday Night and Sunday Morning - Alan Sillitoe 
The Lonely Passion of Judith Hearne - Brian Moore 
The Prime of Miss Jean Brodie - Muriel Spark 
The Remains of the Day - Kazuo Ishiguro 
Emily of New Moon - L. M. Montgomery 
Golden Child - Claire Adam 
Oryx and Crake - Margaret Atwood 
So Long, See You Tomorrow - William Maxwell 
Swami and Friends - R. K. Narayan 
The Outsiders - S. E. Hinton 
Ballet Shoes - Noel Streatfeild 
Cold Comfort Farm - Stella Gibbons 
Middlemarch - George Eliot 
The Tenant of Wildfell Hall - Anne Bronte 
The Witches - Roald Dahl 
American Tabloid - James Ellroy 
American War - Omar El Akkad 
Rebecca - Daphne du Maurier 
Regeneration - Pat Barker 
The Children of Men - P. D. James 
The Hound of the Baskervilles - Sir Arthur Conan Doyle 
The Talented Mr. Ripley - Patricia Highsmith 
The Quiet American - Graham Greene 
Bartleby the Scrivener - Herman Melville 
Habibi - Craig Thompson 
How to be both - Ali Smith 
Nights at the Circus - Angela Carter 
1984 - George Orwell 
The Moor’s Last Sigh - Salman Rushdie 
